a	properties	0
ab	transport	1
abelian	multilevel	2
absence	resolved	1
absolute	gd	2
absorbing	vertical	1
absorption	perturbed	3
ac	coulomb	1
accelerated	correspondence	1
acceleration	correspondence	1
accelerator	activity	2
acceptor	arsenic	3
acceptors	iodine	3
accumulation	fractions	1
accuracy	implications	1
accurate	observations	3
acid	polaritons	2
acoustic	molecules	1
actinide	multiplicity	5
action	fluctuations	2
actions	supersymmetry	1
activated	as	2
activation	backscattering	2
active	capillary	1
activity	first	0
adaptive	aln	1
adatom	cooled	2
adatoms	rectangular	0
addendum	gravitation	5
additional	depolarization	2
adhesion	cuprate	0
adiabatic	continuous	1
ads	seesaw	0
adsorbate	smectic	5
adsorbates	nonradiative	3
adsorbed	ch	4
adsorption	dipole	0
ag	exact	0
aggregates	superlattice	0
aggregation	wetting	2
aging	branes	1
aharonov	signal	0
air	dephasing	1
al	si	4
alas	yba	3
alfv	gradient	3
algebra	poles	1
algebraic	diamagnetic	3
algorithm	information	0
algorithms	measuring	1
aligned	fully	0
alignment	enhancement	0
alkali	copper	6
alkaline	displacement	4
all	fano	0
alloy	dimension	0
alloying	similar	0
alloys	pseudopotential	3
aln	dots	1
alpha	some	8
alphen	pion	4
alternating	interferometry	0
alternative	separated	1
aluminum	sound	1
amorphization	spinodal	1
amorphous	compounds	2
amplification	pressures	2
amplifier	deposited	2
amplitude	vertex	4
amplitudes	helium	4
an	analysis	0
analog	beryllium	5
analyses	br	1
analysis	waves	0
analytic	ternary	2
analytical	influence	0
analyzing	tas	3
anchoring	tip	1
anderson	walks	1
andreev	ultrashort	0
angle	anderson	1
angles	formulas	5
angular	transfer	1
anharmonic	reflectivity	2
anharmonicity	multichannel	4
anisotropic	membranes	0
anisotropies	nucleation	0
anisotropy	crystals	2
annealed	hydrostatic	3
annealing	oscillatory	2
annihilation	blende	2
annihilations	backward	8
anomalies	specific	1
anomalous	field	0
anomaly	charge	2
ansatz	stretched	2
anti	optimization	1
antiferroelectric	gravitating	3
antiferromagnet	attractor	2
antiferromagnetic	membranes	0
antiferromagnetism	bubbles	3
antiferromagnets	echo	2
antiproton	positron	5
apparent	g	2
appearance	class	2
application	approximation	3
applications	polymeric	1
applied	variables	1
approach	systems	1
approaches	interactions	3
approximate	precise	3
approximation	formalism	3
approximations	derivation	3
aqueous	species	0
ar	muonium	6
arbitrary	cylindrical	1
are	droplet	2
argon	ionized	7
array	weakly	0
arrays	r	0
arsenic	acceptor	3
arsenide	znte	6
artificial	sized	2
as	monolayer	0
aspects	estimates	3
assembled	synchronization	1
assembly	qubits	0
assisted	controlling	0
associated	mass	1
astrophysical	stretching	0
asymmetric	constrained	0
asymmetries	probe	0
asymmetry	s	0
asymptotic	doppler	4
asymptotically	recent	6
atmospheric	ladder	1
atom	models	1
atomic	anomalous	1
atomistic	nanoparticles	0
atoms	direct	0
attachment	cosmic	2
attenuation	insb	4
attosecond	fidelity	0
attraction	box	0
attractive	unconventional	0
attractor	antiferromagnet	2
attractors	manifolds	3
au	like	0
auger	nbse	3
augmented	alkaline	5
autocorrelation	nucleons	4
autoionization	satellites	6
autoionizing	overlayer	4
automata	porous	1
avalanches	hermitian	2
average	pd	1
avoiding	fr	3
axial	vector	4
axion	conductor	5
axis	tevatron	1
axisymmetric	detector	2
azimuthal	fault	1
b	coherent	0
ba	undoped	3
background	ru	0
backgrounds	species	1
backscattering	interatomic	1
backward	quadrupole	6
bag	chemisorbed	4
balance	sample	2
ballistic	dichroism	2
band	electron	1
bands	tetrahedral	4
bandwidth	hydrodynamics	1
bang	complexity	0
bare	conjecture	3
barium	linearized	5
barrier	ga	1
barriers	fermions	0
baryogenesis	hollow	0
baryon	leptonic	5
baryons	charmonium	4
based	individual	0
basis	screening	2
bath	markovian	0
batio	laboratory	1
bcc	synchrotron	2
bcs	twisted	0
be	particles	2
beam	instabilities	0
beams	determining	2
beats	prompt	4
bec	fidelity	1
bedt	orbits	2
behavior	critical	1
bell	not	0
below	tm	2
bending	compact	1
bent	maximally	0
berry	gpa	2
beryllium	sound	3
beta	kbr	6
bethe	lengths	4
between	its	1
bev	algebra	4
beyond	flavor	0
bi	y	3
bias	nanocrystals	0
biased	index	0
biaxial	superposition	0
bifurcation	bistable	2
bifurcations	nard	1
bilayer	environments	0
bilayers	magic	0
billiard	surfactant	0
billiards	exclusion	1
binaries	environments	1
binary	nature	1
binding	band	3
biological	complexity	1
bipartite	nanotubes	0
birefringence	reconstructed	3
bis	intercalation	5
bismuth	lead	4
bistability	graphite	5
bistable	freezing	1
black	spatial	1
blende	annihilation	2
bloch	gaussian	0
block	similar	1
blockade	universal	1
blue	incommensurate	3
body	why	2
bogoliubov	inequalities	2
bohm	perturbative	0
boltzmann	detectors	0
bombardment	molybdenum	2
bond	space	2
bonded	spectrum	3
bonding	core	1
bonds	hierarchical	3
bootstrap	regge	2
born	quadrupole	4
boron	bubble	0
bose	photonic	0
boson	interface	1
bosonic	orbit	1
bosons	spaces	1
bottom	superposition	1
bound	er	2
boundaries	phase	1
boundary	formation	0
bounded	nn	3
bounds	cubic	3
box	attraction	0
br	analyses	1
bragg	optimization	0
branching	detector	1
brane	world	0
branes	aging	1
breakdown	diodes	2
breaking	perturbation	1
breakup	complete	2
breathing	cell	1
bremsstrahlung	total	6
bright	membrane	0
brillouin	auger	3
broadband	bath	2
broadened	pionic	5
broadening	linewidth	5
broken	leptonic	4
brownian	comparative	1
bubble	boron	0
bubbles	like	1
bulk	gaps	0
bundles	brane	1
burning	stages	1
bursts	locked	0
c	null	1
ca	sr	0
cabibbo	cesium	3
cacu	intermittency	2
cadmium	thallium	4
caf	germanium	7
calcium	zinc	5
calculated	dye	5
calculating	hamiltonians	2
calculation	studies	3
calculations	plasmon	1
can	coexistence	1
canonical	importance	1
capacitance	diode	1
capacity	hydrodynamic	1
capillary	open	0
capture	integrals	5
carbide	evanescent	1
carbon	pyrochlore	0
carlo	monte	0
carrier	change	0
carriers	multilayered	4
cascade	nearly	1
cascades	mobility	1
case	its	1
casimir	chirality	0
cation	capacity	1
causality	cubic	2
caused	circular	3
cavities	ferromagnetic	0
cavity	detectors	0
cd	schwinger	5
cds	chloride	8
cdse	hall	1
cdte	quasiperiodic	3
ce	hopping	3
cell	regimes	0
cells	detectors	0
cellular	epitaxial	1
center	trends	4
centered	schwinger	5
centers	gallium	5
central	inversion	2
cerium	niobium	7
cern	performance	1
cesium	cabibbo	3
cf	multiphonon	3
ch	adsorbed	4
chain	process	1
chains	spatial	0
change	carrier	0
changes	statistical	2
changing	redistribution	1
channel	carbide	1
channeling	pionic	4
channels	rotation	0
chaos	nard	2
chaotic	axis	1
character	intense	1
characteristic	alfv	4
characteristics	qcd	2
characterization	asymmetric	0
charge	models	1
charged	fragmentation	2
charges	involving	4
charging	packets	1
charm	diagonal	4
charmed	tetracyanoquinodimethane	5
charmonium	left	2
chemical	light	0
chemisorbed	bag	4
chemisorption	isoelectronic	5
chern	simons	1
chiral	ac	1
chirality	engineering	0
chloride	germanium	6
cholesteric	tricritical	7
chromium	yttrium	4
chromodynamics	bag	6
circuit	landscape	0
circular	ultrathin	1
circularly	repulsion	1
cl	tm	2
class	dy	2
classical	atoms	1
classification	derivative	2
clean	reflectivity	2
clock	fractions	1
cloning	leptogenesis	1
close	m	1
closed	impact	3
cloud	species	1
cluster	spectroscopy	0
clustering	detectors	0
clusters	relaxation	0
cm	born	5
cmb	walled	0
cn	connection	2
co	dependent	1
coalescence	tip	0
coarsening	cuprates	2
cobalt	direction	3
coefficient	construction	3
coefficients	vibrations	6
coexistence	molecules	1
coherence	influence	0
coherent	b	0
coherently	sensitive	0
cohesive	diamagnetic	4
coincidence	inertia	3
cold	ferromagnetic	0
collapse	patterns	1
collective	onset	0
collider	measures	0
colliders	images	1
colliding	ta	5
collinear	astrophysical	1
collision	representation	3
collisional	fine	3
collisionless	inertia	4
collisions	observation	1
colloidal	flavor	0
colloids	sheared	0
color	materials	2
colored	cdte	4
colossal	bundles	1
columnar	fermilab	1
combination	penning	3
combined	continuous	1
commensurate	grand	3
comment	heavy	3
comments	pions	7
communication	chirality	1
compact	suspensions	1
comparative	intermittent	0
comparison	continuum	2
compensation	can	2
competing	higgs	0
competition	universal	0
complete	inflationary	1
complex	single	0
complexes	observables	0
complexity	neutralino	0
component	vacancy	3
components	der	4
composite	onset	4
composites	unstable	1
composition	related	1
compound	locking	1
compounds	amorphous	2
compressed	extreme	1
compressibility	sign	4
compressible	hysteresis	2
compression	magic	1
compton	jahn	5
computation	wall	0
computational	cuprate	0
computer	extremely	1
computing	carbon	1
concentrated	multiply	3
concentration	thermodynamic	2
condensate	photonic	0
condensates	einstein	1
condensation	magic	0
condensed	thermopower	3
condition	pairs	2
conditions	interaction	0
conductance	periodically	0
conducting	chiral	1
conduction	mobility	1
conductivity	phonon	1
conductor	doubly	1
conductors	derived	1
cone	magnetoelastic	3
configuration	polarizability	2
configurations	cubic	2
confined	dynamics	0
confinement	scalar	1
confining	yan	2
conformal	destruction	1
conjecture	bare	3
conjugated	chaotic	2
connected	intermittent	2
connection	construction	1
consequences	pseudoscalar	3
conservation	differences	7
conserved	rule	4
conserving	kink	4
consistency	decay	4
consistent	inversion	3
constant	deformed	2
constants	zinc	5
constituent	ginzburg	3
constrained	asymmetric	0
constraining	chirality	0
constraint	hydrodynamics	1
constraints	universal	0
construction	cascade	1
contact	operation	0
contacts	suppression	0
containing	final	2
content	xy	2
continuous	adiabatic	1
continuum	transient	1
contribution	intensity	2
contributions	potentials	2
control	nanocrystals	0
controlled	devices	0
controlling	next	0
convection	solvable	2
convective	eigenstates	2
convergence	various	4
conversion	magnetically	2
coo	chirality	0
cooled	gel	2
cooling	correlated	0
cooper	switching	1
cooperative	ferromagnets	2
coordinate	er	2
coordinates	lagrangian	3
copolymer	inas	0
copper	tl	5
core	theory	0
corrected	technicolor	0
correction	radial	2
corrections	identification	1
correlated	packet	0
correlation	temperature	0
correlations	bubble	1
correspondence	mapping	0
cosmic	loops	1
cosmological	alternating	1
cosmologies	inflationary	3
cosmology	asymmetric	0
couette	hybridization	1
coulomb	threshold	1
counting	dna	2
coupled	dynamics	0
coupling	transmission	1
couplings	dissociative	3
covalent	ratios	3
covariant	der	2
coverage	microscope	2
covered	hydrogenlike	4
cp	hard	0
cpt	dusty	1
cr	temperature	2
crack	plastic	1
creation	distortions	1
creep	epitaxy	2
criterion	expanding	1
critical	transitions	0
criticality	asymmetric	0
cross	section	3
crossed	impedance	2
crossing	curie	3
crossover	dissipation	0
crystal	like	1
crystalline	composition	1
crystallization	ordered	1
crystals	liquid	1
cs	processes	2
cu	well	3
cubic	configurations	2
cucl	photoelectrons	4
cugeo	superdeformed	7
cummings	selected	1
cuo	microscope	1
cuprate	adhesion	0
cuprates	inas	2
curie	crossing	3
current	gold	3
currents	current	5
curvature	nonlinearities	0
curve	singly	4
curved	orthorhombic	1
curves	gd	3
cutoff	refractive	1
cycle	protein	0
cyclotron	acceptors	6
cylinder	nonequilibrium	1
cylinders	correspondence	1
cylindrical	bubble	1
d	dynamic	2
damage	monatomic	2
damped	clean	3
damping	cubic	2
dark	terahertz	0
data	alternating	2
dc	excitonic	1
de	ferrimagnetic	3
debye	aspects	4
decay	off	3
decaying	physics	0
decays	matching	1
decoherence	lensing	0
decomposition	melting	2
deconfinement	search	2
decoupling	particle	3
deep	susceptibility	9
deeply	proximity	3
defect	exact	2
defects	diffusion	1
deficient	connected	2
deformation	functionals	0
deformations	ir	2
deformed	rate	1
degeneracy	body	3
degenerate	temperatures	3
degree	astrophysical	0
degrees	absence	1
delay	cp	1
delayed	stokes	0
delocalization	alloying	1
demonstration	storage	0
dendritic	quasiperiodic	4
dense	real	1
densities	susceptibility	3
density	gas	1
dependence	operator	2
dependent	linear	0
dephasing	injection	1
depinning	conjugated	2
depletion	signals	1
depolarization	additional	2
deposited	integrable	1
deposition	neural	1
depth	traveling	0
der	waals	1
derivation	approximations	3
derivative	classification	2
derived	conductors	1
description	fields	1
design	chirality	0
desorption	hydrogen	4
destruction	diffuse	1
detachment	hyperspherical	3
detailed	moving	2
detected	coverage	3
detecting	environments	1
detection	passage	1
detector	prediction	0
detectors	boltzmann	0
determination	spinodal	2
determined	multichannel	3
determining	beams	2
deterministic	pairing	0
deuterium	linewidth	7
deuteron	cerium	7
deuterons	some	5
development	dirac	1
deviations	proposed	3
device	matter	0
devices	controlled	0
diagonal	diagrams	3
diagonalization	traveling	1
diagram	structural	0
diagrams	mo	2
diamagnetic	algebraic	3
diamond	intermittency	2
diatomic	gradient	3
dichroism	organized	2
dicke	vo	1
dielectric	rate	0
dielectrics	samples	1
dielectronic	doubling	5
difference	triple	4
differences	cesium	4
different	probe	0
differential	technique	3
diffraction	structure	1
diffractive	manganese	5
diffuse	ground	0
diffusion	periodic	1
diffusive	nonlinearity	0
dilaton	integer	2
dilepton	degrees	2
dilute	isomer	4
diluted	reference	2
dimension	alloy	0
dimensional	system	0
dimensionality	nb	4
dimensions	rayleigh	1
dimer	arrays	0
dimers	lateral	0
dinger	schr	1
diode	optically	1
diodes	breakdown	2
dioxide	value	3
dipolar	pairs	0
dipole	adsorption	0
dipoles	post	2
dirac	development	1
direct	atoms	0
directed	qcd	0
direction	dispersion	1
directional	aspects	4
dirty	limiting	4
discharge	peaks	3
discharges	cuo	3
discrete	cp	0
disk	unconventional	0
disks	sige	0
dislocation	accelerated	2
dislocations	diodes	2
disorder	structures	1
disordered	scaling	1
dispersion	direction	1
dispersions	neutrinoless	3
dispersive	resonantly	2
displacement	mobility	2
dissipation	crossover	0
dissipative	experiment	1
dissociation	chain	1
dissociative	couplings	3
distance	lu	3
distorted	impulse	4
distortion	minimum	1
distortions	creation	1
distributed	filled	0
distribution	velocity	1
distributions	fast	2
divergence	recoil	4
dna	based	1
do	is	3
does	constant	3
domain	regime	0
domains	gratings	0
dominance	cadmium	4
dominated	mn	1
donor	variational	3
donors	variational	7
dopant	modification	0
doped	thin	0
doping	transport	0
doppler	production	2
dot	rev	0
dots	ultrashort	1
double	effect	1
doublet	loops	2
doubling	avoiding	4
doubly	highly	1
drag	complexity	0
drell	yan	1
dressed	carrier	1
drift	picture	4
driven	weakly	0
driving	superposition	1
drop	oscillating	1
droplet	transformation	1
droplets	strongly	1
drops	muon	5
dual	helicity	5
duality	collisionless	5
due	like	1
dust	violating	2
dusty	cpt	1
dy	class	2
dye	satellite	2
dynamic	co	2
dynamical	stochastic	0
dynamics	coupled	0
dyson	sites	3
e	screening	3
early	propagator	1
earth	recoil	4
easy	thermodynamics	1
echo	interatomic	1
echoes	niobium	6
edge	motion	2
edges	anisotropies	1
effect	generation	0
effective	onset	1
effects	threshold	0
efficiency	based	0
efficient	controlled	0
eigenstates	logarithmic	2
eigenvalue	plus	3
eigenvalues	adsorbates	4
eikonal	reactions	6
einstein	condensates	1
el	skyrmion	5
elastic	values	3
elasticity	universal	0
electric	pulsed	1
electrical	limit	3
electro	species	1
electrodynamics	quadrupole	5
electromagnetic	condition	3
electromagnetically	nanocrystals	0
electron	band	1
electronic	spectroscopy	1
electrons	intensity	3
electroproduction	spontaneously	7
electrostatic	particle	2
electroweak	pinning	2
element	probe	2
elementary	bethe	4
elements	elastic	3
embedded	asymmetric	0
emergence	multiscale	1
emission	temperature	1
emitted	acceptors	4
emitting	trapped	0
empirical	third	3
energetic	semiconducting	1
energetics	gels	1
energies	spectra	1
energy	invariant	0
engineering	chirality	0
enhanced	its	0
enhancement	alignment	0
ensemble	asymmetric	0
ensembles	membrane	0
entangled	bose	2
entanglement	qubit	0
entropic	flavor	1
entropy	weakly	1
envelope	aligned	2
environment	single	0
environments	bilayer	0
epitaxial	cellular	1
epitaxy	integrable	2
epr	kr	4
equal	trajectories	2
equation	behavior	1
equations	universality	0
equilibration	cellular	1
equilibrium	external	1
equivalence	pumped	3
equivalent	cesium	4
er	coordinate	2
erratum	anderson	2
error	cycle	0
escape	change	1
esr	pionic	5
estimate	recent	4
estimates	heated	2
estimation	based	0
et	resonant	0
eu	quasielastic	1
euclidean	acid	5
europium	tin	3
ev	capture	6
evaluation	simple	3
evanescent	propagation	0
evaporation	site	2
even	resistivity	5
event	complexity	0
events	lived	2
evidence	excitations	2
evolution	dynamics	1
exact	ag	0
exactly	content	2
example	minimum	2
excess	intermolecular	1
exchange	relation	2
excitable	luttinger	0
excitation	susceptibility	5
excitations	random	1
excited	critical	2
exciton	temperature	2
excitonic	dc	1
excitons	hopping	2
exclusion	passive	1
exclusive	its	0
existence	divergence	4
exotic	five	2
expanding	stokes	1
expansion	critical	2
expansions	total	6
experiment	mechanical	0
experimental	point	0
experiments	maximum	0
explanation	blende	2
explicit	drell	2
explosion	underdoped	0
exponent	vibrational	3
exponential	photodetachment	3
exponents	positronium	3
expression	canonical	2
extended	exact	2
extension	lagrangian	2
external	symmetric	0
extra	quintessence	2
extraction	deformation	2
extreme	incoherent	1
extremely	computer	1
f	product	2
factor	extension	3
factorization	why	2
factors	form	2
faddeev	feynman	3
failure	acoustic	1
family	inhomogeneous	0
fano	all	0
far	studies	2
faraday	alfv	3
fast	classical	2
fault	detector	1
fcc	mechanics	2
fe	perpendicular	0
features	dynamic	2
feedback	magic	0
femtosecond	mesoscopic	0
fermi	lattices	1
fermilab	columnar	1
fermion	transient	2
fermionic	bosonic	1
fermions	barriers	0
ferrimagnetic	de	3
ferroelectric	based	0
ferroelectrics	mass	5
ferromagnet	rotating	1
ferromagnetic	cavities	0
ferromagnetism	wall	0
ferromagnets	cooperative	2
feshbach	nanowire	0
few	nanoparticles	0
feynman	faddeev	3
fiber	cuprate	0
fibers	deformation	1
fibonacci	sputtered	4
fidelity	magnetoelectric	0
field	anomalous	0
fields	the	0
filaments	cycle	0
filled	optics	0
filling	curvature	0
film	dynamics	0
films	resonant	1
filtering	cuprate	1
final	g	2
fine	collisional	3
finite	wave	0
first	activity	0
fission	nickel	6
five	index	1
fixed	virtual	2
flat	fourier	1
flavor	ultrashort	0
flight	methane	3
flip	pb	3
flow	nonlinearity	0
flows	cuprate	0
fluctuating	suppression	1
fluctuation	instability	1
fluctuations	resonant	1
fluid	charge	1
fluids	emission	1
fluorescence	nearest	3
fluoride	total	6
fluorine	subshell	3
flux	equilibration	2
fock	explanation	2
focusing	soft	1
foil	iv	8
foils	coordinates	6
fokker	changing	3
folding	texture	1
following	lamb	4
forbidden	theorems	4
force	asymmetric	0
forced	loops	0
forces	measurement	1
form	factors	2
formalism	freedom	2
formation	boundary	0
formed	tilt	1
forming	neutralino	0
forms	estimate	4
formula	conduction	3
formulas	involving	4
formulation	contributions	3
forward	zinc	5
four	erratum	2
fourier	flat	1
fourth	phosphorus	5
fr	quasicrystal	2
fractal	superlattice	1
fractals	avoiding	3
fraction	modified	1
fractional	monte	1
fractions	bath	1
fracture	tip	1
fragment	orientational	4
fragmentation	models	2
fragments	powers	5
frame	tensor	3
framework	storage	1
free	orientation	0
freedom	formalism	2
freezing	bistable	1
frenkel	submonolayer	2
frequencies	semiconducting	2
frequency	thermal	1
friction	sb	1
from	light	0
front	colliders	2
fronts	inas	1
frustrated	pairing	1
frustration	based	0
full	based	0
fullerene	tip	0
fullerenes	vicinal	2
fully	aligned	0
function	behavior	2
functional	storage	0
functionals	deformation	0
functions	l	2
fundamental	tests	2
further	multiplet	4
fusion	oscillator	5
future	measuring	0
g	cascade	1
ga	barrier	1
gaas	superlattices	3
gadolinium	rest	5
gain	cellular	1
galactic	storage	0
gallium	centers	5
gamma	neutrons	7
gamow	incommensurate	4
gan	pseudogap	1
gap	interfaces	0
gaps	bulk	0
garnet	ii	4
gas	pressure	1
gasb	manganese	5
gaseous	ne	5
gases	nanocrystals	2
gate	lett	1
gates	nanotube	0
gauge	quarks	3
gauss	terahertz	0
gaussian	bloch	0
gd	nuclei	2
ge	ionization	2
gel	integer	1
gels	hard	1
general	dynamic	2
generalization	conduction	2
generalized	properties	1
generated	activity	0
generating	nonequilibrium	1
generation	effect	0
generic	controlling	0
geometric	single	0
geometrical	locking	1
geometries	sphere	1
geometry	process	0
germanium	i	5
gev	pu	6
ghost	split	1
giant	solutions	2
ginzburg	constituent	3
glass	transition	1
glasses	heavy	4
glassy	reactive	1
glauber	gravitation	6
global	like	0
globally	hermitian	3
glueball	neutrinoless	6
gluon	space	0
gold	current	3
goldstone	iii	4
gordon	sine	3
gpa	burning	1
gradient	diatomic	3
gradients	conduction	2
grain	pattern	0
grains	holography	1
grand	commensurate	3
granular	trapped	1
graphene	lhc	1
graphite	bistability	5
graphs	bogoliubov	2
grating	experiment	0
gratings	domains	0
gravitating	grains	1
gravitation	addendum	5
gravitational	universal	0
gravity	detector	0
grazing	texture	0
green	mixture	2
gross	correspondence	2
ground	diffuse	0
group	integration	3
growing	loops	1
grown	reconstruction	1
growth	reply	1
guided	alternating	1
h	spectra	4
haas	garnet	5
hadron	li	2
hadronic	e	4
hadrons	tungsten	5
haldane	photorefractive	0
half	signals	0
halide	uranium	5
halides	ssbauer	6
hall	junction	0
halo	interlayer	3
hamiltonian	solution	3
hamiltonians	reconstructed	2
handed	bipartite	0
hard	cp	0
harmonic	properties	1
harmonics	easy	2
hartree	iii	3
hawking	crack	1
hcp	photoelectrons	4
hd	screened	3
he	ne	3
heat	electrical	3
heated	estimates	2
heating	photon	3
heavily	th	3
heavy	comment	3
heisenberg	coulomb	1
helical	orbital	2
helicity	dioxide	3
helium	amplitudes	4
heliumlike	thomas	4
hermitian	plastic	1
heterogeneous	ultrashort	1
heterojunctions	cdte	4
heterostructure	orientational	2
heterostructures	cellular	2
heusler	nanowire	0
hexagonal	unconventional	0
hf	forbidden	5
hg	integrals	4
hidden	revealed	0
hierarchical	langevin	2
hierarchy	sensitivity	0
higgs	competing	0
high	approach	1
higher	spontaneous	1
highly	doubly	1
ho	dressed	2
hole	process	0
holes	polymer	0
hollow	baryogenesis	0
holographic	performance	0
holography	grains	1
holstein	noisy	1
homogeneous	breaking	2
hopping	excitons	2
horizon	ice	0
host	explicit	3
hot	inp	2
how	coexistence	1
hubbard	flux	3
hybrid	post	0
hybridization	steady	1
hydride	photoelectrons	5
hydrides	heated	4
hydrodynamic	variation	1
hydrodynamics	sector	1
hydrogen	mechanics	3
hydrogenated	desorption	6
hydrogenic	tas	5
hydrogenlike	positronium	3
hydrostatic	lines	3
hyperfine	amplitudes	5
hypernuclei	birefringence	3
hyperon	bethe	5
hyperspherical	detachment	3
hypothesis	isotopes	3
hysteresis	unconventional	1
i	ii	3
ice	horizon	0
icosahedral	manifolds	2
ideal	rh	4
identical	wannier	4
identification	corrections	1
ii	i	3
iii	hartree	3
image	reentrant	2
images	colliders	1
imaging	based	0
impact	blende	2
impedance	crossed	2
implanted	susceptibility	6
implementation	carbon	1
implications	dependent	1
importance	canonical	1
improved	viscosity	0
impulse	distorted	4
impurities	polarizability	1
impurity	contribution	2
in	structural	0
inas	copolymer	0
incidence	variation	1
incident	gev	10
inclusion	sm	3
inclusive	addendum	6
incoherent	nonequilibrium	1
incommensurate	blue	3
independent	particle	2
index	measure	0
indirect	anomalies	2
indium	crossing	3
individual	based	0
induced	pressure	0
inelastic	cross	5
inequalities	quasinormal	2
inequality	matter	0
inertia	coincidence	3
inertial	nonlinearities	1
infinite	energies	5
inflation	nonlinearity	0
inflationary	complete	1
influence	coherence	0
information	algorithm	0
infrared	exact	2
inhomogeneities	asymmetric	1
inhomogeneity	structured	0
inhomogeneous	family	0
initial	response	0
initio	single	0
injection	orbital	1
inner	hcp	4
inp	hot	2
insb	attenuation	4
inside	orbit	0
instabilities	beam	0
instability	instabilities	1
instanton	peak	3
instantons	tetrahedral	2
insulating	influence	0
insulator	nonlinearity	0
insulators	vicinity	1
integer	axis	1
integrable	octupole	1
integral	photoelectron	4
integrals	projectiles	3
integration	group	3
intense	instabilities	1
intensities	photoelectrons	5
intensity	contribution	2
interacting	light	0
interaction	conditions	0
interactions	pairs	2
interatomic	echo	1
interband	determined	4
intercalated	tas	3
intercalation	dielectronic	5
interface	boson	1
interfaces	gap	0
interfacial	microscopy	1
interference	qcd	0
interferometer	fano	0
interferometers	dna	1
interferometric	sized	0
interferometry	alternating	0
interlayer	magnetoresistance	1
intermediate	semiconductors	2
intermetallic	coordinate	5
intermittency	diamond	2
intermittent	comparative	0
intermolecular	excess	1
internal	containing	4
interplay	nanocrystals	0
interpretation	linewidth	4
interstitial	is	2
intersubband	microscope	1
intrinsic	probe	0
invariance	simplified	6
invariant	energy	0
inverse	oscillator	1
inversion	central	2
investigated	transparency	0
investigation	measurement	0
investigations	instabilities	2
involving	formulas	4
iodine	linewidths	3
ion	phenomena	1
ionic	er	3
ionization	w	1
ionized	yields	4
ions	neighbor	1
ir	nonequilibrium	1
iron	batio	4
irradiated	zone	5
irradiation	annealing	3
irreversibility	globally	4
irreversible	xy	2
is	particle	1
ising	screening	3
island	rectangular	0
islands	complexity	0
isobaric	knight	5
isoelectronic	leptons	3
isolated	neutrino	1
isomer	pu	4
isomeric	isospin	4
isomers	problems	2
isoscalar	monopoles	4
isospin	zone	3
isotope	ratio	3
isotopes	hypothesis	3
isotopic	samples	4
isotropic	intense	1
isovector	systematics	6
itinerant	vacancies	2
its	exclusive	0
iv	noble	3
j	electroweak	3
jahn	compton	5
jaynes	selected	1
jellium	avoiding	3
jet	hydrodynamics	1
jets	polar	2
jona	lasinio	0
jones	exponential	3
josephson	structures	1
jump	repulsive	3
jumps	microstructure	1
junction	hall	0
junctions	single	0
k	factors	6
kaluza	reference	3
kaon	degenerate	4
kbr	beta	6
kcl	ultrasonic	4
kerr	domain	1
kev	argon	7
kicked	varying	1
kinematic	relations	3
kinetic	semiconductor	1
kinetics	solvable	2
kink	nonuniform	2
kinks	reduction	1
klein	spaces	2
knight	stripping	4
kohn	identification	2
kondo	weakly	0
kosterlitz	photoexcited	2
kr	epr	4
kramers	zero	2
krypton	potassium	6
l	functions	2
la	grain	1
laboratory	pumping	1
ladder	baryogenesis	1
ladders	terminated	1
lagrangian	yb	2
lamb	susceptibilities	2
lamellar	nard	2
lamno	leg	1
landau	crystal	1
landscape	circuit	0
langevin	spaces	1
langmuir	rough	2
lanthanum	cesium	5
large	neutrino	0
laser	spectroscopy	0
lasers	multimode	1
lasing	wormholes	2
lasinio	jona	0
late	spreading	0
lateral	dimers	0
lattice	light	0
lattices	rings	0
law	mn	1
laws	carbide	2
layer	defects	2
layered	ordering	0
layers	excitations	1
lead	bismuth	4
leading	capillary	0
learning	dichroism	3
lee	verification	4
left	moving	0
leg	nanocrystalline	1
length	arrays	1
lengths	bethe	4
lennard	jones	3
lensing	manipulation	0
leptogenesis	bipartite	1
lepton	are	2
leptonic	curie	3
leptons	isoelectronic	3
lett	sqrt	0
level	multiple	2
levels	bremsstrahlung	8
lhc	torque	0
li	hadron	2
lif	multiplet	7
life	quadrupole	4
lifetime	property	2
lifetimes	po	4
lifshitz	plateau	1
light	lattice	0
like	au	0
limit	character	1
limitations	is	5
limited	stretched	2
limiting	re	4
limits	angle	1
line	fcc	2
linear	dependent	0
linearized	reconstructed	3
linearly	correction	4
lines	hydrostatic	3
linewidth	interpretation	4
linewidths	iodine	3
lipid	spatial	1
liquid	crystals	1
liquids	crystals	1
lithium	configurations	5
lived	events	2
lo	roughening	4
local	three	0
localization	melting	1
localized	velocity	1
locked	bursts	0
locking	compound	1
logarithmic	expanding	2
long	properties	0
longitudinal	pressures	1
loop	universal	0
loops	forced	0
lorentz	controlled	2
loss	inverse	2
losses	oh	2
low	threshold	0
lower	multipole	3
lowest	section	3
lu	instability	3
luminescence	anharmonic	4
luttinger	excitable	0
lyapunov	tevatron	1
lying	dy	4
m	coulomb	1
macroscopic	competing	0
magic	bilayers	0
magnesium	sound	4
magnet	chirality	0
magnetic	dynamics	0
magnetically	viscosity	1
magnetism	molecules	0
magnetization	nonlinearity	0
magnetized	index	1
magneto	organized	1
magnetoelastic	dispersion	2
magnetoelectric	fidelity	0
magnetohydrodynamic	multicomponent	1
magnetoresistance	interlayer	1
magnetotransport	suppression	0
magnets	controlling	1
magnon	piezoelectric	5
magnons	vanishing	4
majorana	jets	2
manganese	para	4
manganite	carbon	0
manganites	branes	1
manifolds	icosahedral	2
manipulation	lensing	0
many	separated	1
map	ultrathin	1
mapping	correspondence	0
maps	regular	0
markovian	bath	0
martensitic	activated	3
maser	lines	5
mass	associated	1
masses	spheres	2
massive	problems	2
massless	ultraviolet	3
master	deformation	0
matched	volume	2
matching	scale	1
material	b	0
materials	b	1
matrices	measurements	1
matrix	channel	2
matter	device	0
maximal	dephasing	1
maximally	bent	0
maximum	experiments	0
maxwell	vacuum	3
mean	crystal	1
means	electrical	3
measure	index	0
measured	cascades	1
measurement	investigation	0
measurements	matrices	1
measures	collider	0
measuring	future	0
mechanical	experiment	0
mechanics	fcc	2
mechanism	dependent	0
mechanisms	dynamical	0
media	structures	1
mediated	flavor	0
medium	external	0
melt	submonolayer	1
melting	localization	1
membrane	ensembles	0
membranes	anisotropic	0
memory	detectors	0
mercury	nickel	5
meson	factors	6
mesons	ferroelectrics	5
mesoscopic	spiral	0
metal	structure	0
metallic	free	1
metals	nickel	7
metamaterials	multiferroic	0
metastability	bifurcation	4
metastable	technique	3
methane	simplified	2
method	atoms	0
methods	neutron	1
metric	massive	4
mev	krypton	20
mg	residual	3
mgb	quintessence	3
mgo	five	1
microcavities	microcavity	0
microcavity	microcavities	0
microscope	intersubband	1
microscopic	relativistic	1
microscopy	interfacial	1
microstructure	tube	1
microwave	suppression	2
migration	incoherent	1
mills	yang	2
minima	widths	4
minimal	towards	0
minimum	variables	1
mirror	vacancies	1
missing	methane	3
mixed	evidence	2
mixing	quasi	0
mixture	anderson	1
mixtures	interaction	2
mn	law	1
mnf	thallium	4
mno	gan	1
mo	diagrams	2
mobility	conduction	1
mode	pressure	0
model	transition	1
modeling	nanocrystals	0
models	atom	1
modes	effect	1
modification	dopant	0
modifications	gaps	1
modified	precession	0
modulated	fractional	3
modulation	localized	1
moduli	cosmic	1
modulus	associated	2
molecular	pressure	0
molecule	adiabatic	1
molecules	scheme	0
molybdenum	bombardment	2
moment	inertia	4
momenta	cabibbo	5
moments	annealing	2
momentum	polar	2
monatomic	sign	2
monolayer	as	0
monolayers	conductors	1
monopole	hydrides	5
monopoles	isoscalar	4
monte	carlo	0
moo	superstring	6
morphology	axis	1
motion	kinetic	1
motions	echo	3
mott	controlled	0
moving	left	0
multi	theorem	1
multichannel	determined	3
multicomponent	magnetohydrodynamic	1
multidimensional	sensitive	1
multielectron	jets	2
multiferroic	metamaterials	0
multifractal	microscope	1
multifragmentation	poly	2
multilayer	tube	2
multilayered	squeezing	3
multilayers	ballistic	2
multilevel	abelian	2
multimode	mean	1
multiparticle	hf	7
multipartite	heusler	0
multiphonon	cf	3
multiphoton	quantization	4
multiple	interfaces	1
multiplet	further	4
multiplicative	melt	2
multiplicity	actinide	5
multiply	rapidity	1
multipole	lower	3
multiscale	tuning	0
muon	ferromagnets	5
muonic	subshell	2
muonium	ar	6
muons	neon	6
mutual	orthogonal	3
n	frequency	1
na	measured	1
nacl	p	9
nambu	fibers	1
nanoclusters	operations	0
nanocrystalline	aging	1
nanocrystals	electromagnetically	0
nanometer	mesoscopic	2
nanoparticle	qubits	0
nanoparticles	few	0
nanoscale	nanoparticles	0
nanostructures	nanoparticles	0
nanotube	gates	0
nanotubes	bipartite	0
nanowire	heusler	0
nanowires	nanowire	0
nard	bifurcations	1
narrow	trends	3
narrowing	sections	4
natural	resonances	2
nature	resolution	0
nb	component	3
nbse	auger	3
nd	stepped	1
ne	he	3
near	transient	0
nearest	quasielastic	1
nearly	cascade	1
negative	tev	1
neighbor	ions	1
nematic	atom	1
neon	muons	6
network	detectors	0
networks	switching	1
neural	deposition	1
neurons	spinel	0
neutral	bound	4
neutralino	complexity	0
neutralization	conduction	4
neutrino	large	0
neutrinoless	delayed	2
neutrinos	nn	1
neutron	vacancies	1
neutrons	tin	6
new	susceptibility	5
newtonian	heterogeneous	1
next	controlling	0
nh	explanation	3
ni	structure	1
nickel	mercury	5
nio	conductance	1
niobium	echoes	6
nitride	coupling	1
nitrogen	refractive	1
nm	incidence	2
nmr	giant	3
nn	neutrinos	1
no	generalized	1
noble	iv	3
noise	doped	1
noisy	holstein	1
non	universal	0
nonadiabatic	inflationary	2
nonclassical	traveling	1
noncollinear	chirality	0
noncommutative	cloning	1
nonconservation	distorted	6
nondegenerate	microscope	4
nondemolition	chern	3
nonequilibrium	stokes	1
nonleptonic	europium	4
nonlinear	structures	1
nonlinearities	curvature	0
nonlinearity	inflation	0
nonlocal	channels	0
nonlocality	ultrashort	0
nonmagnetic	particles	2
nonperturbative	composites	1
nonradiative	adsorbates	3
nonrelativistic	substituted	3
nonresonant	uniform	2
nonuniform	absence	1
nonuniversal	doublet	2
nonzero	signals	0
normal	solvable	2
not	bell	0
note	qubit	0
novel	localization	2
np	molybdenum	4
nuclear	vector	3
nucleation	anisotropies	0
nuclei	series	1
nucleon	vibrations	4
nucleons	hydrogenlike	4
nucleosynthesis	parallel	0
nucleus	quarks	5
null	semiclassical	0
number	dependent	0
numerical	dissipative	1
o	surface	3
objects	migration	1
observables	complexes	0
observation	collisions	1
observations	yb	2
observed	rates	1
obtained	nonrelativistic	3
octet	columnar	7
octupole	integrable	1
odd	breaking	1
off	conformal	2
oh	losses	2
on	approach	1
one	process	0
onset	collective	0
open	capillary	0
operation	contact	0
operations	nanoclusters	0
operator	dependence	2
operators	realistic	2
optic	strangeness	3
optical	transport	0
optically	diode	1
optics	filled	0
optimal	nanocrystals	0
optimization	bragg	0
optimized	fano	1
orbit	principles	0
orbital	injection	1
orbitals	shapes	4
orbits	nard	2
order	dependent	1
ordered	kinetic	1
ordering	layered	0
organic	single	0
organization	tip	1
organized	magneto	1
orientation	free	0
orientational	reflectivity	1
oriented	polycrystalline	3
origin	scheme	0
orthogonal	noisy	1
orthorhombic	photoexcitation	1
os	section	4
oscillating	cuprate	1
oscillation	background	1
oscillations	weakly	1
oscillator	inverse	1
oscillators	stable	0
oscillatory	annealing	2
out	weakly	0
output	capillary	0
overlap	cascades	2
overlayer	autoionizing	4
overlayers	overlayer	5
oxidation	sio	1
oxide	ho	3
oxides	equilibration	2
oxygen	modulated	4
p	forbidden	7
packet	correlated	0
packets	charging	1
packing	collinear	1
pair	radial	1
pairing	deterministic	0
pairs	dipolar	0
palladium	acceptor	4
para	predicted	3
parabolic	irreversibility	4
parallel	nucleosynthesis	0
paramagnetic	equal	4
parameter	operator	2
parameters	radiation	0
parametric	patterns	1
parametrization	pseudo	3
parity	harmonics	3
partial	tests	3
partially	cp	3
particle	is	1
particles	nonmagnetic	2
partition	detected	3
parton	swift	5
passage	search	1
passive	exclusion	1
path	oscillator	3
paths	sequences	1
pattern	grain	0
patterns	suppression	1
pauli	ultraviolet	2
pb	flip	3
pbte	rearrangement	6
pd	average	1
peak	standing	2
peaks	distortions	2
peierls	frenkel	3
penetration	null	2
penning	combination	3
percolation	fermion	2
perfect	suppressed	0
performance	holographic	0
period	quantization	3
periodic	diffusion	1
periodically	conductance	0
perovskite	aln	1
perovskites	pseudogap	1
perpendicular	fe	0
persistence	acceleration	1
persistent	pinning	2
perturbation	breaking	1
perturbations	proximity	2
perturbative	bohm	0
perturbed	damped	3
pf	surfactant	3
phase	in	1
phases	wave	1
phenomena	ion	1
phenomenological	residual	3
phenomenology	parameters	2
phenomenon	criterion	2
phonon	conductivity	1
phonons	pumped	3
phosphorus	missing	4
photoabsorption	nucleons	4
photoconductivity	acceptor	5
photodetachment	quasielastic	1
photodisintegration	coincidence	11
photoelectron	nearest	2
photoelectrons	widths	3
photoemission	heavy	5
photoexcitation	orthorhombic	1
photoexcited	kosterlitz	2
photoinduced	walls	1
photoionization	plasmas	1
photoluminescence	kinetics	2
photon	semi	2
photonic	bose	0
photons	dominated	2
photoproduction	pole	3
photorefractive	haldane	0
phys	dot	0
physical	plasmon	2
physics	polarization	0
picosecond	absorption	5
picture	perturbation	2
piezoelectric	dioxide	3
pinch	pb	4
pinned	spherically	1
pinning	reply	2
pion	alphen	4
pionic	channeling	4
pions	tungsten	5
planar	trapping	0
planck	effective	3
plane	diffusion	2
planes	wells	3
plasma	nature	1
plasmas	photoionization	1
plasmon	calculations	1
plasmons	anomalies	4
plastic	hermitian	1
plateau	lifshitz	1
platinum	su	4
plus	quadratic	2
pn	flight	5
po	consequences	4
point	experimental	0
points	tensor	2
poisson	polar	1
polar	poisson	1
polariton	index	0
polaritons	compressed	2
polarizabilities	gd	2
polarizability	impurities	1
polarization	physics	0
polarized	properties	0
polaron	anomalies	2
polarons	vibrational	2
pole	photoproduction	3
poles	algebra	1
poly	reexamined	1
polyacetylene	chemisorbed	6
polycrystalline	oriented	3
polymer	suppression	0
polymeric	applications	1
polymers	defects	1
populated	pions	5
population	comparative	1
populations	post	0
porous	melt	1
position	u	1
positive	lepton	3
positron	trends	3
positronium	nearest	3
positrons	fluorine	4
possibility	proof	5
possible	electric	4
post	hybrid	0
potassium	positrons	5
potential	screening	2
potentials	simple	1
potts	desorption	5
powder	bosons	1
power	anderson	1
powers	heavily	5
pp	stellar	2
pr	separation	2
prba	superdeformed	4
precession	modified	0
precise	approximate	3
precision	experiment	1
predicted	extreme	3
prediction	detector	0
predictions	applied	2
preparation	rapidly	2
prepared	poly	2
presence	spectroscopy	2
pressure	induced	0
pressures	longitudinal	1
primary	lee	4
primordial	controlling	1
principle	minimum	2
principles	orbit	0
probabilities	iii	3
probability	picture	2
probe	asymmetries	0
probed	ultrashort	0
probes	colloids	3
probing	based	0
problem	emission	1
problems	construction	2
procedure	charges	5
process	geometry	0
processes	cs	2
processing	sized	1
produced	projectiles	3
product	hydrodynamics	1
production	doppler	2
products	neon	6
profiles	anomalies	3
projected	superfluidity	0
projectile	projectiles	4
projectiles	integrals	3
projection	physical	2
prompt	beats	4
proof	coordinates	3
propagating	standing	2
propagation	evanescent	0
propagator	early	1
properties	a	0
property	lifetime	2
proposal	split	0
proposed	deviations	3
protein	cycle	0
proteins	wall	0
proton	rule	5
protons	stripping	7
proximity	perturbations	2
pseudo	parametrization	3
pseudogap	gan	1
pseudopotential	alloys	3
pseudopotentials	reflectivity	4
pseudoscalar	consequences	3
pt	trapping	0
pu	isomer	4
publisher	nanowire	1
pulse	flavor	0
pulsed	electric	1
pulses	single	1
pump	sensitive	1
pumped	equivalence	3
pumping	laboratory	1
pure	magnetically	2
pyrochlore	carbon	0
q	intense	2
qcd	standard	0
qed	aharonov	1
quadratic	plus	2
quadrupolar	blende	3
quadrupole	born	4
quantitative	probe	0
quantization	period	3
quantized	activation	2
quantum	domain	0
quark	ni	2
quarkonium	blue	3
quarks	gauge	3
quartz	schottky	2
quasi	mixing	0
quasicrystal	fr	2
quasicrystals	silicon	5
quasielastic	photodetachment	1
quasifree	substitutional	6
quasinormal	inequalities	2
quasiparticle	chain	1
quasiparticles	nonlinearity	0
quasiperiodic	cdte	3
qubit	note	0
qubits	assembly	0
quenched	composition	2
quenching	limits	2
quintessence	brane	2
r	arrays	0
rabi	jona	1
radial	thresholds	1
radiation	parameters	0
radiative	photoionization	5
radii	pseudoscalar	4
radio	degeneracy	3
radius	dy	4
raman	solid	2
random	excitations	1
randomly	so	3
range	properties	0
rapid	incoherent	1
rapidity	multiply	1
rapidly	preparation	2
rare	zeeman	6
rashba	fidelity	0
rate	dielectric	0
rates	observed	1
ratio	measurements	2
ratios	covalent	3
ray	theoretical	0
rayleigh	dimensions	1
rays	haas	5
rb	position	3
re	degeneracy	4
reaction	asymptotic	6
reactions	eikonal	6
reactive	glassy	1
real	tension	0
realistic	operators	2
realization	air	1
rearrangement	molybdenum	5
recent	degeneracy	3
recoil	earth	4
recombination	upper	2
reconnection	orbit	0
reconstructed	hamiltonians	2
reconstruction	studied	1
reconstructions	ultrarelativistic	1
recovery	branching	3
rectangular	adatoms	0
redistribution	changing	1
reduced	accelerator	2
reduction	absence	1
reentrant	image	2
reexamined	poly	1
reference	criterion	2
reflectance	frenkel	4
reflection	liquids	2
reflectivity	orientational	1
refraction	twisted	0
refractive	cutoff	1
regge	bootstrap	2
regime	domain	0
regimes	cell	0
region	cl	3
regions	probability	3
regular	maps	0
regularization	nondegenerate	4
related	composition	1
relation	experimental	1
relations	kinematic	3
relationship	applied	3
relative	multi	3
relativistic	microscopic	1
relativity	parameters	3
relaxation	clusters	0
relaxations	ultrahigh	0
relaxor	carbon	0
remarks	recent	5
renormalization	fast	3
renormalized	mo	2
reorientation	be	3
replies	fr	3
reply	growth	1
representation	collision	3
representations	yield	3
repulsion	circularly	1
repulsive	precision	2
residual	yb	1
resistance	projection	2
resistive	nambu	2
resistivity	susceptibilities	4
resolution	nature	0
resolved	absence	1
resonance	van	4
resonances	separated	1
resonant	et	0
resonantly	semileptonic	1
resonating	superstring	5
resonator	weighted	1
resonators	fano	0
respond	bag	5
response	initial	0
rest	iron	5
restoration	flat	1
restricted	picture	2
results	dimension	2
rev	dot	0
revealed	hidden	0
reversal	flavor	0
reversed	columnar	3
reversible	influence	0
review	cummings	7
revisited	nanocrystalline	2
rf	vibration	3
rh	changes	2
rich	universal	0
rigid	methods	2
rigorous	schwinger	6
ring	water	0
rings	lattices	0
robust	lensing	0
rods	shock	1
role	asymmetric	0
room	calculations	2
rotating	ring	1
rotation	channels	0
rotational	uniaxial	4
rotor	objects	2
rough	nard	2
roughening	integrable	2
roughness	dissipation	1
ru	background	0
rubidium	ultraviolet	3
ruby	ionized	5
rule	shift	1
rules	sum	4
running	explosion	1
ruo	dusty	1
rutile	oh	3
rydberg	stage	3
s	asymmetry	0
saddle	reconstructed	3
salpeter	yttrium	6
salt	theorem	3
salts	positrons	7
sample	varying	1
samples	dielectrics	1
sampling	seesaw	1
sandpile	photorefractive	2
satellite	dye	2
satellites	sine	3
saturated	slowing	2
saturation	formulas	4
sb	tev	1
sc	curie	3
scalar	thermodynamics	1
scalars	simulated	2
scale	b	1
scales	probe	0
scaling	disordered	1
scanning	substitution	0
scattered	even	6
scattering	infinite	6
scenario	sized	1
scheme	molecules	0
schemes	injection	3
schottky	quartz	2
schr	exact	1
schwarzschild	left	2
schwinger	schottky	3
screened	proof	3
screening	potential	2
se	variational	3
sea	interstitial	3
search	passage	1
second	processes	3
secondary	anomalies	4
section	lowest	3
sections	narrowing	4
sector	hydrodynamics	1
seesaw	ads	0
segregation	initial	1
selected	jaynes	1
selection	crossed	2
selective	properties	0
selenium	linewidths	6
self	separation	1
semi	synchrotron	1
semiclassical	null	0
semiconducting	energetic	1
semiconductor	kinetic	1
semiconductors	intermediate	2
semiflexible	membrane	0
semileptonic	resonantly	1
sensitive	coherently	0
sensitivity	hierarchy	0
separable	ne	4
separated	alternative	1
separation	self	1
sequence	vacancy	2
sequences	paths	1
sequential	reduced	2
series	nuclei	1
set	masses	4
sets	skyrmion	2
shallow	fr	2
sham	scalars	2
shape	process	1
shaped	horizon	0
shapes	orbitals	4
sharp	systematic	2
shear	b	0
sheared	colloids	0
shell	heating	4
shells	parameters	2
shielding	gaseous	5
shift	rule	1
shifts	approximations	6
shock	ring	1
short	intense	1
shot	complexity	0
si	surfaces	2
sic	absorbing	2
sige	disks	0
sigma	persistence	1
sign	mobility	1
signal	aharonov	0
signals	viscoelastic	0
signature	probe	0
signatures	structured	0
silica	like	0
silicon	inp	4
silver	covalent	5
similar	alloying	0
similarity	packets	3
simons	chern	1
simple	potentials	1
simplified	methane	2
simulated	smooth	1
simulation	interfacial	1
simulations	based	0
simultaneous	vicinity	1
sine	gordon	3
single	complex	0
singlet	cascade	1
singly	confining	3
singular	longitudinal	3
singularities	van	2
singularity	c	3
sio	variation	1
site	doubly	1
sites	eu	1
sitter	acceleration	1
situ	ultrahigh	0
six	mixtures	3
size	packet	1
sized	interferometric	0
skyrme	thermalization	2
skyrmion	sets	2
slab	stokes	3
sliding	tilt	2
slip	fano	1
slow	asymmetric	1
slowing	saturated	2
sm	antiferromagnets	2
small	wave	1
smectic	comment	4
smooth	forced	1
sn	der	3
so	supergravity	3
sodium	hg	4
soft	is	1
softening	reduced	2
solar	nm	2
solid	raman	2
solidification	fr	3
solids	lamb	3
solitary	vesicles	2
soliton	percolation	2
solitons	dynamic	2
soluble	widths	4
solution	hamiltonian	3
solutions	giant	2
solvable	spinodal	1
solvent	mapping	1
solving	fault	1
some	stripping	4
sound	aluminum	1
source	based	0
sources	pumping	2
sp	sector	2
space	gluon	0
spaces	bosons	1
spacetime	transmission	0
spacetimes	cp	0
spatial	chains	0
spatially	gratings	2
spatiotemporal	mesoscopic	2
special	vanishing	3
species	synthesis	0
specific	anomalies	1
spectra	energies	1
spectral	ultrathin	0
spectroscopic	spectrum	1
spectroscopy	cluster	0
spectrum	spectroscopic	1
speed	branes	2
sphere	variation	0
spheres	universe	1
spherical	effect	1
spherically	pinned	1
spin	single	0
spinel	neurons	0
spinning	superposition	3
spinodal	solvable	1
spinor	cmb	2
spins	refractive	2
spiral	mesoscopic	0
split	proposal	0
splitting	soft	2
splittings	uranium	5
spontaneous	thermodynamic	1
spontaneously	singly	5
spreading	late	0
sputtered	fibonacci	4
sputtering	dyson	3
sqrt	lett	0
square	trapping	1
squeezed	microscope	3
squeezing	multilayered	3
sr	ca	0
srtio	gases	2
ssbauer	halides	6
stability	like	0
stabilization	acoustic	2
stabilized	texture	1
stable	oscillators	0
stacking	variation	1
stage	rydberg	3
stages	burning	1
staggered	cuprate	0
standard	qcd	0
standing	unstable	2
star	flavor	0
stark	multiphoton	4
stars	locked	0
state	properties	0
states	intense	1
static	relativistic	2
stationary	spherically	1
statistical	changes	2
statistics	bubble	1
steady	precision	1
stellar	traps	1
step	magnetoresistance	3
stepped	nd	1
steps	gel	3
stimulated	quantized	2
stm	aln	1
stochastic	dynamical	0
stokes	delayed	0
stopping	pseudopotentials	5
storage	functional	0
strain	asymmetric	0
strained	wells	2
strange	melting	2
strangeness	optic	3
strength	transient	2
strengths	detachment	4
stress	ti	1
stretched	ansatz	2
stretching	astrophysical	0
string	y	2
strings	heterostructures	3
stripe	branes	1
stripes	aging	1
stripping	some	4
strong	focusing	1
strongly	spacetime	1
strontium	radio	4
structural	in	0
structure	metal	0
structured	inhomogeneity	0
structures	nonlinear	1
studied	nonlinear	1
studies	far	2
study	temperature	1
su	platinum	4
sub	weight	2
subband	thomas	4
subject	disks	0
submonolayer	melt	1
subpicosecond	planes	6
subshell	muonic	2
substituted	br	2
substitution	scanning	0
substitutional	autoionizing	4
substrate	light	0
substrates	influence	0
subwavelength	heusler	0
sulfur	hydrogenlike	5
sum	rules	4
super	asymmetric	0
superconducting	modifications	2
superconductivity	crystal	3
superconductor	gaps	0
superconductors	string	2
supercooled	tilted	1
superdeformed	prba	4
superfluid	droplet	2
superfluidity	projected	0
supergravity	universe	1
superheavy	factorization	6
superlattice	aggregates	0
superlattices	gaas	3
supernova	index	1
superposition	biaxial	0
superstring	resonating	5
supersymmetric	oscillation	2
supersymmetry	actions	1
supported	based	0
suppressed	perfect	0
suppression	polymer	0
surface	surfaces	1
surfaces	surface	1
surfactant	billiard	0
susceptibilities	lamb	2
susceptibility	densities	3
suspension	weakly	1
suspensions	nonlinearities	1
swift	particles	2
switching	detectors	1
symmetric	external	0
symmetries	observations	3
symmetry	nonlinearity	0
synchronization	photonic	1
synchrotron	semi	1
synthesis	species	0
system	dimensional	0
systematic	instabilities	1
systematics	projectiles	3
systems	approach	1
t	mechanics	5
ta	fluorescence	3
tail	methane	4
tails	taylor	4
target	transfer	2
targets	nbse	4
tas	analyzing	3
taylor	oscillator	3
tb	splitting	2
tcnq	tetracyanoquinodimethane	4
te	photoexcitation	2
technicolor	corrected	0
technique	blende	2
techniques	generalization	2
teleportation	bundles	1
teller	central	3
temperature	correlation	0
temperatures	related	3
temporal	expanding	1
tension	real	0
tensor	droplet	1
terahertz	dark	0
term	sector	1
terminated	ladders	1
terms	evaluation	5
ternary	photodetachment	2
test	elastic	3
testing	universal	0
tests	fundamental	2
tetracyanoquinodimethane	tcnq	4
tetragonal	dy	3
tetrahedral	instantons	2
tetrathiafulvalene	tetracyanoquinodimethane	5
tev	sb	1
tevatron	axis	1
texture	grazing	0
th	heavily	3
thallium	mnf	4
the	fields	0
their	can	1
theorem	multi	1
theorems	molybdenum	4
theoretic	quadrupole	5
theoretical	ray	0
theories	gauge	4
theory	core	0
thermal	interaction	1
thermalization	as	1
thermally	ternary	2
thermodynamic	light	1
thermodynamics	family	1
thermoelectric	wake	1
thermopower	propagating	2
thick	pressures	2
thickness	dissipative	1
thin	doped	0
third	empirical	3
thomas	heliumlike	4
thouless	activated	2
three	local	0
threshold	effects	0
thresholds	radial	1
ti	stress	1
tight	emission	2
tilt	gratings	1
tilted	hard	1
time	analysis	0
times	walks	2
tin	europium	3
tio	wall	0
tip	coalescence	0
titanium	simplified	4
tl	absorption	5
tm	cl	2
tmtsf	photoexcited	5
tokamak	kr	5
tomography	chirality	0
top	ultrathin	1
topological	backgrounds	1
topology	fano	0
toroidal	triple	4
torque	lhc	0
torsion	cern	3
torus	events	3
total	feynman	4
towards	minimal	0
traffic	billiards	1
trajectories	equal	2
trajectory	iron	5
trans	sputtered	4
transfer	angular	1
transform	thresholds	2
transformation	droplet	1
transformations	equilibrium	2
transient	near	0
transients	hydrogenlike	4
transistor	wall	0
transistors	nanocrystals	0
transition	structure	1
transitions	critical	0
translational	radial	2
transmission	spacetime	0
transparency	investigated	0
transport	optical	0
transverse	order	1
trap	wurtzite	0
trapped	emitting	0
trapping	planar	0
traps	stellar	1
traveling	depth	0
treatment	photoemission	5
tree	optically	1
trends	annihilation	2
triangular	slip	1
tricritical	multiplicity	6
triple	der	3
triplet	not	1
ttf	instanton	6
tube	complexes	1
tunable	multiscale	0
tungsten	pions	5
tuning	multiscale	0
tunnel	channels	0
tunneling	reply	3
turbulence	suppression	0
turbulent	disks	1
twin	tev	1
twist	inflationary	1
twisted	refraction	0
two	system	1
type	liquids	3
types	probe	1
u	position	1
ultracold	heusler	0
ultrafast	based	0
ultrahigh	relaxations	0
ultrarelativistic	reconstructions	1
ultrashort	flavor	0
ultrasonic	kcl	4
ultrathin	spectral	0
ultraviolet	pauli	2
uncertainty	thermal	1
unconventional	hexagonal	0
underdoped	explosion	0
understanding	weighted	0
undoped	gpa	1
uniaxial	average	1
unification	fermions	4
unified	quarks	7
uniform	close	2
unitarity	equal	6
unitary	batio	2
universal	gravitational	0
universality	equations	0
universe	supergravity	1
universes	stokes	2
unoccupied	avoiding	3
unstable	kinetic	1
unusual	view	1
upper	recombination	2
upt	alas	4
uranium	iodine	4
use	acceptor	4
using	universal	0
uv	differences	4
v	rate	2
vacancies	neutron	1
vacancy	sequence	2
vacuum	energy	1
valence	photoelectron	4
validity	relationship	5
valley	fidelity	4
value	nitrogen	2
values	elastic	3
van	singularities	2
vanadium	deviations	3
vanishing	semiconducting	2
vapor	kink	2
variable	molecule	1
variables	minimum	1
variation	sphere	0
variational	auger	3
variations	coexistence	1
various	convergence	4
varying	delocalization	1
vector	nuclear	3
velocities	estimate	4
velocity	instabilities	1
veneziano	poles	4
verification	lee	4
versus	domain	0
vertex	metastable	3
vertical	gan	1
very	simple	2
vesicles	solitary	2
vi	brillouin	5
via	detectors	0
vibration	rf	3
vibrational	polarons	2
vibrations	impurity	3
vibronic	iodine	5
vicinal	fullerenes	2
vicinity	simultaneous	1
view	unusual	1
violating	neutralino	1
violation	oscillators	1
virial	proposed	5
virtual	fixed	2
viscoelastic	signals	0
viscosity	improved	0
viscous	signals	0
visible	population	2
vo	dicke	1
voltage	bubble	1
volume	transformation	1
vortex	organized	2
vortices	dynamics	1
vy	holstein	2
w	ionization	1
waals	der	1
wake	thermoelectric	1
walk	langevin	2
walks	anderson	1
wall	computation	0
walled	cmb	0
walls	photoinduced	1
wannier	gain	2
water	ring	0
wave	finite	0
waveguide	controlled	0
waveguides	wall	0
wavelength	ternary	3
waves	analysis	0
weak	configuration	3
weakly	kondo	0
weight	twin	1
weighted	understanding	0
well	multifractal	3
wells	strained	2
wetting	aggregation	2
what	creation	1
white	epitaxial	2
why	left	2
wide	carbide	2
width	parameters	2
widths	photoelectrons	3
wigner	aharonov	1
wilson	view	2
wire	dimers	1
wires	ultrathin	0
world	brane	0
wormholes	fibers	2
wurtzite	trap	0
x	fractional	2
xe	densities	5
xenon	donor	4
xy	doubly	1
y	string	2
yan	drell	1
yang	mills	2
yb	residual	1
yba	alas	3
yield	representations	3
yields	ionized	4
yrast	so	6
yttrium	chromium	4
yukawa	hard	2
z	solid	2
zeeman	nucleon	5
zener	detectors	0
zero	kramers	2
zeros	optic	8
zhang	poly	1
zinc	rule	4
zn	excitons	3
zno	heusler	0
zns	vibrations	5
znse	lo	5
znte	jaynes	5
zone	na	2
zr	connection	3
